RED = "\033[31m"

Maze = ("""
_________________________
|   __|   _____    __   |
|  |   __   |  |__|   __|
|___  |  |__|   __    __|
|  |  |  |     |  |  |  |
|  |     |_____|  |  |  |
|  |  |___________      |
|  |   _____      |  |  |
|__|________|__|_____|__|

        """)
